
1111111111111111
1CP10000000C1111
100E001111001111
1000110000001111
1111111111111111
1111111111111111
1111111111111111