1111111111111111111111111111111111
100000010000000C00000C000000000001
1010010100100000101001000000010101
1010010110101010001001000000010101
1P000E010C00C0000000000000000000C1
1111111111111111111111111111111111